{
  "孙策": "骑",
  "周瑜": "弓",
  "孙权": "盾",
  "甘宁": "骑",
  "陆逊": "弓",
  "鲁肃": "盾",
  "太史慈": "骑",
  "吕蒙": "弓",
  "黄盖": "盾",
  "孙尚香": "骑",
  "程普": "弓",
  "周泰": "盾",
  "陆抗": "弓",
  "孙坚": "盾",
  "徐盛": "盾",
  "凌统": "骑",
  "韩当": "弓",
  "张昭": "盾",
  "董袭": "骑",
  "潘璋": "弓",
  "丁奉": "盾",
  "陈武": "骑",
  "大乔": "弓",
  "蒋钦": "盾",
  "诸葛瑾": "骑",
  "小乔": "弓",
  "步骘": "盾",
  "诸葛恪": "骑",
  "朱然": "弓",
  "朱桓": "盾",
  "吕范": "骑",
  "步练师": "弓",
  "孙桓": "盾",
  "张纮": "骑",
  "周姬": "弓",
  "朱治": "盾",
  "全琮": "骑",
  "孙鲁班": "弓",
  "顾雍": "盾",
  "曹操": "骑",
  "荀彧": "弓",
  "司马懿": "盾",
  "张辽": "骑",
  "荀攸": "弓",
  "典韦": "盾",
  "郭嘉": "骑",
  "邓艾": "弓",
  "许褚": "盾",
  "程昱": "骑",
  "钟会": "弓",
  "曹仁": "盾",
  "乐进": "骑",
  "夏侯渊": "弓",
  "于禁": "盾",
  "张郃": "骑",
  "满宠": "弓",
  "徐晃": "盾",
  "夏侯惇": "骑",
  "庞德": "弓",
  "郝昭": "盾",
  "曹丕": "骑",
  "臧霸": "弓",
  "郭淮": "盾",
  "曹真": "骑",
  "曹休": "弓",
  "文聘": "盾",
  "曹纯": "骑",
  "甄姬": "弓",
  "李典": "盾",
  "曹洪": "骑",
  "张春华": "弓",
  "王双": "盾",
  "曹彰": "骑",
  "王元姬": "弓",
  "曹植": "盾",
  "王朗": "骑",
  "卞夫人": "弓",
  "杨修": "盾",
  "关羽": "骑",
  "诸葛亮": "弓",
  "刘备": "盾",
  "赵云": "骑",
  "庞统": "弓",
  "张飞": "盾",
  "姜维": "骑",
  "黄忠": "弓",
  "魏延": "盾",
  "马超": "骑",
  "徐庶": "弓",
  "法正": "盾",
  "关兴": "骑",
  "黄月英": "弓",
  "张苞": "盾",
  "关平": "骑",
  "严颜": "弓",
  "周仓": "盾",
  "关银屏": "骑",
  "王平": "弓",
  "廖化": "盾",
  "马云禄": "骑",
  "马谡": "弓",
  "陈到": "盾",
  "马岱": "骑",
  "甘夫人": "弓",
  "黄权": "盾",
  "李严": "骑",
  "吴懿": "弓",
  "刘禅": "盾",
  "糜竺": "骑",
  "沙摩柯": "弓",
  "马良": "盾",
  "费祎": "骑",
  "董允": "弓",
  "伊籍": "盾",
  "孙乾": "骑",
  "蒋琬": "弓",
  "简雍": "盾",
  "吕布": "骑",
  "张角": "弓",
  "董卓": "盾",
  "贾诩": "骑",
  "汉灵帝": "弓",
  "袁术": "盾",
  "公孙瓒": "骑",
  "袁绍": "弓",
  "高顺": "盾",
  "刘表": "骑",
  "陈宫": "弓",
  "刘璋": "盾",
  "吕玲绮": "骑",
  "张宝": "弓",
  "孟获": "盾",
  "颜良": "骑",
  "李儒": "弓",
  "貂蝉": "盾",
  "马腾": "骑",
  "士燮": "弓",
  "皇甫嵩": "盾",
  "左慈": "骑",
  "朱儁": "弓",
  "田丰": "盾",
  "祝融": "骑",
  "卢植": "弓",
  "文丑": "盾",
  "许攸": "骑",
  "于吉": "弓",
  "华佗": "盾",
  "韩遂": "骑",
  "麴义": "弓",
  "兀突骨": "盾",
  "张曼成": "骑",
  "沮授": "弓",
  "张梁": "盾",
  "张绣": "骑",
  "邹氏": "弓",
  "胡车儿": "盾"
}